333333333333333
300000000100003
301111000102103
322000002200123
300000010000003
300000010000003
300022210010003
300000000010003
311000000012003
300112200002113
300002010002003
301101010000003
300001000000003
333333333333333